8 10
B T B T T C M M M T
T T T T T C M M M T
L L C C T C C T T T
T L B B B C C T T L
T L T T T L C T T C
T B B T T M M M T T
C T T T T M M M T T
T T T T T C C T T C